thawing_frozen_food	train
boxing_books_up_for_storage	train
preparing_salad	train
bringing_in_wood	train
serving_hors_d_oeuvres	train
washing_floor	train
putting_up_Christmas_decorations_inside	train
cleaning_up_the_kitchen_only	train
installing_a_scanner	train
watering_houseplants	train
installing_a_modem	train
cleaning_high_chair	train
storing_the_groceries	train
cleaning_up_after_a_meal	train
clearing_the_table_after_dinner	train
bottling_fruit	train
installing_alarms	train
packing_lunches	train
cleaning_kitchen_cupboard	train
polishing_shoes	train
installing_a_fax_machine	train
polishing_furniture	train
preparing_a_shower_for_child	train
organizing_school_stuff	train
cleaning_out_drawers	train
cleaning_garage	train
making_tea	train
storing_food	train
cleaning_the_pool	train
filling_a_Christmas_stocking	train
brushing_lint_off_clothing	train
organizing_file_cabinet	train
rearranging_furniture	train
cleaning_a_car	train
packing_picnics	train
serving_a_meal	train
re-shelving_library_books	train
assembling_gift_baskets	train
putting_away_Christmas_decorations	train
waxing_cars_or_other_vehicles	train
collect_misplaced_items	train
putting_leftovers_away	train
picking_up_trash	train
cleaning_shoes	train
opening_packages	train
loading_the_dishwasher	train
cleaning_stove	train
packing_adult_s_bags	train
setting_mousetraps	train
defrosting_freezer	train
polishing_silver	train
laying_wood_floors	train
cleaning_microwave_oven	train
packing_boxes_for_household_move_or_trip	train
collecting_aluminum_cans	train
throwing_away_leftovers	train
cleaning_up_refrigerator	train
organizing_boxes_in_garage	train
cleaning_bathtub	train
cleaning_closet	train
preserving_food	val
mopping_floors	val
washing_cars_or_other_vehicles	val
packing_bags_or_suitcase	val
sorting_groceries	val
cleaning_toilet	val
cleaning_table_after_clearing	val
cleaning_sneakers	val
cleaning_floors	val
installing_a_printer	val
opening_presents	val
sorting_books	val
washing_pots_and_pans	val
laying_tile_floors	val
setting_up_candles	val
packing_food_for_work	val
sorting_mail	val
chopping_vegetables	val
locking_every_window	val
cleaning_oven	val
putting_away_Halloween_decorations	test
putting_away_toys	test
locking_every_door	test
moving_boxes_to_storage	test
unpacking_suitcase	test
picking_up_take-out_food	test
filling_an_Easter_basket	test
vacuuming_floors	test
washing_dishes	test
cleaning_windows	test
putting_dishes_away_after_cleaning	test
cleaning_freezer	test
cleaning_bathrooms	test
packing_car_for_trip	test
cleaning_cupboards	test
cleaning_the_hot_tub	test
cleaning_bedroom	test
cleaning_carpets	test
cleaning_barbecue_grill	test
packing_child_s_bag	test
